SGGGGAGG
RRRGGAGG
GGGGGAGT
GGRRRRRR
GGGGGGGG
TGGGGGGE
