SGGGGGGGGGGG
RRRRRRRRGATT
GGGGGGGGGAGG
GGRRRRRRRRRR
GGGGGGGGGGGE
